1111111111111111
1000000000000001
10000P0000000001
1001111111111101
1000000000000001
11111111100C0001
1000000000100001
1000110000101101
10C0000E00100001
10000000001C0001
1111111111111111