NO texture/north.xpm
F 220,100,0
SO texture/south.xpm
WE texture/west.xpm
C 225,30,0
EA texture/east.xpm

1111111111111111111111111  1  11111
10000000000010100111000011111110001
1111111100011111000001110S000000111
10000000010000000000001100000000001
11001111111111111111111111111110111
 1001                         101
 10011111111111111111111111111001
 1000PPPPPPPPPPPPPPPPPPPPPPP000011
 11111111111111001111111111111111
11111    11   1111 111 11






