NO texture/north.xpm
F 220,100,0
SO texture/south.xpm
WE texture/west.xpm
C 225,30,0
EA texture/east.xpm

1111111111111111111111111  1  11111
10000000000010100111000011111110001
1111111100011111000001110S00000011111111111111111111111
10000000000000000000000000000000000000000000000000000001
1100111111111111111111111111111011111111111111111111111
 1001                         101
 10011111111111111111111111111001
 1000PPPPPPPPPPPPPPPPPPPPPPP000011
 1111111111111100111111111111111111111111111111111111111
11111    11   1111 111 11






